####################.###################
#.##.##.##.##.##.##.##.##.##.##.##.##.#
#..##..##..##..##..##..##..##..##..##..#
#########....##############....#########
#..##..##..##..##..##..##..##..##..##..#
#.##.##.##.##.##.##.##.##.##.##.##.##.#
####....############....############....
#..##..##..##..##..##..##..##..##..##..#
#.##.##.##.##.##.##.##.##.##.##.##.##.#
###########....############....#########
#..##..##..##..##..##..##..##..##..##..#
#.##.##.##.##.##.##.##.##.##.##.##.##.#
#####....############....###############
#..##..##..##..##..##..##..##..##..##..#
#.##.##.##.##.##.##.##.##.##.##.##.##.#
#..##..##..##..##..##..##..##..##..##..#
####################.###################

