####################.###################
#.##.##.##.##.##.##.##.##.##.##.##.##.#
#..##..##..##..##..##..##..##..##..##..#
#######....##############....###########
#..##..##..##..##..##..##..##..##..##..#
#.##.##.##.##.##.##.##.##.##.##.##.##.#
....############....############....####
#..##..##..##..##..##..##..##..##..##..#
#.##.##.##.##.##.##.##.##.##.##.##.##.#
###########....############....#########
#..##..##..##..##..##..##..##..##..##..#
#.##.##.##.##.##.##.##.##.##.##.##.##.#
#####....############....###############
#..##..##..##..##..##..##..##..##..##..#
#.##.##.##.##.##.##.##.##.##.##.##.##.#
#..##..##..##..##..##..##..##..##..##..#
........................................
####################.###################

