####################.###################
#.##.##.##.##.##.##.##.##.##.##.##.##.#
#..##..##..##..##..##..##..##..##..##..#
#####....############....###############
#..##..##..##..##..##..##..##..##..##..#
#.##.##.##.##.##.##.##.##.##.##.##.##.#
....############....############....####
#..##..##..##..##..##..##..##..##..##..#
#.##.##.##.##.##.##.##.##.##.##.##.##.#
###########....############....#########
#..##..##..##..##..##..##..##..##..##..#
#.##.##.##.##.##.##.##.##.##.##.##.##.#
#########....##############....#########
#..##..##..##..##..##..##..##..##..##..#
#.##.##.##.##.##.##.##.##.##.##.##.##.#
#..##..##..##..##..##..##..##..##..##..#
####################.###################

