####################.###################
#.##.##.##.##.##.##.##.##.##.##.##.##.#
#..##..##..##..##..##..##..##..##..##..#
#####.....###########....###############
#..##..S...##..##..##..##..##..##..##..#
#.##.#...#.##.##.##.##.##.##.##.##.##.#
#######....##############....###########
#..##......##..##..##..##..##..##..##..#
#.##....##.##.##.##.##.##.##.##.##.##.#
......##########....############....####
#..##..##..##..##..##..##..##..##..##..#
#.##.##.##.##.##.##.##.##.##.##.##.##.#
#########....##############....#########
#..##..##..##..##..##..##..##..##..##..#
#.##.##.##.##.##.##.##.##.##.##.##.##.#
#..##..##..##..##..##..##..##..##..##..#
........................................
####################.###################

