####################.###################
#.##.##.##.##.##.##.##.##.##.##.##.##.#
#..##..##..##..##..##..##..##..##..##..#
###########....############....#########
#..##..##..##..##..##..##..##..##..##..#
#.##.##.##.##.##.##.##.##.##.##.##.##.#
####....############....############....
#..##..##..##..##..##..##..##..##..##..#
#.##.##.##.##.##.##.##.##.##.##.##.##.#
#########....##############....#########
#..##..##..##..##..##..##..##..##..##..#
#.##.##.##.##.##.##.##.##.##.##.##.##.#
#######....##############....###########
#..##..##..##..##..##..##..##..##..##..#
#.##.##.##.##.##.##.##.##.##.##.##.##.#
#..##..##..##..##..##..##..##..##..##..#
####################W###################

